......................
......................
......................
....@.................
#######,,,,###########
######################
......................
......................
......................
......................
......................
......................
......................
......................
......................
